--------------
--------------
XX-B------B---
X----X---X---B
B----XXB----BB
-B-B---BB---XX
-BX----B--X---
----B----B----
B--XXX----BBB-
-----X--B---B-
-X---B----X--B
-----BB---BX--
--B---XX------
BBB----X------
BB--B---X--X--
-B------------
XB-----BBX----
-------XXX----
--BB---------B
------BB------
--------------
--------------
--------------