--------------
--------------
XXXXXXXXXXXXXX
-----XXXXXX---
--------------
--------------
--------------
--------------
--------------
--------------
--------------
--------------
--------------
--------------
------B-------
----B------B--
BB-----BBBB---
---------B----
--B-B----B----
--B------B----
----BB-----B--
--------------
--------------