--------------
----BBB-------
XX-B-B----B--B
X----X---X--BB
B----XXX----BB
-B-X--BBB---XX
BBX----B--X---
B---B----B----
B--XXX----BBB-
-----X--B---B-
-X-B-B----X--B
-----BB---BX--
--BB-XX------B
XBB----X---BB-
BB--B---X--X--
-B------B-----
XX----BBBX---B
B------XXX--B-
--BB---B-----B
---B--XX------
---------B----
--------------
--------------