--------------
--------------
XX--------B---
B----X---X---B
B----XBB----BB
-B-B--------XB
-BB----B--X---
----B----B----
---BBX----B---
-----X--------
-X--------X--B
-----BB---BX--
--B---BB------
-------X------
B---B---B--X--
-B------------
XB-----BBX----
-------XXX----
--B----------B
-----B--------
--------------
--------------
--------------