--------------
--------------
--------------
--------------
-X--------B---
----X--B-BX---
B--X---X----B-
X--B-BX-----X-
--------------
---X---X-XB---
--------------
--X--B------XB
--------------
--B--X-XB-----
--------------
--XB--B-B--B--
--------------
B-----B----X--
--------------
----B-------B-
--------------
--------------
------------B-
-X-----XBX-B--
--------------
--------------
--X---B-------
--------------
--------------
----B------B-X
--------------
BB-----BBBB---
--------------
--------------
---X-----B----
--------------
--------------
--B-B----B--B-
--------------
--------------
--B------B----
--------------
--------------
----BB-----B--
--------------
-------B------
--------------
--------------
--------------
--------------
--------------