--------------
--------------
BX--------B---
B----X---B----
-----BBB----BB
-B-B--------BB
-BB-------X---
----B---------
----BX----B---
-----X--------
-X--------X--B
-----BB---BX--
--B---BB------
-------X------
B---B------X--
-B------------
XB-----BBX----
-------BBX----
--B----------B
-----B--------
--------------
--------------
--------------