--------------
--------------
----------B---
-----X--------
-----BBB------
-B-B--------BB
-B--------B---
----B---------
----BX--------
-----X--------
-BB--------X--
----------BB--
--B----B------
--------------
-----------X--
--------------
BB------B-----
-------BBB----
--------------
--------------
--------------
--------------
--------------