--------------
--------------
--------------
-----X--------
-----BBB----B-
---B----------
-B------------
--------------
----BX--------
-----B--------
-BB--------X--
----------BB--
--B----B------
--------------
-----------B--
--------------
BB------------
-------BBB-B--
-----------B--
--------------
--------------
--------------
--------------